1111111111111
1C010000000C1
110C011111001
1P0010E00C001
1111111111111
1111111111111
1111111111111